Gs^Fp, Gs^Fp, Ss, Gs^Fp, Gs^Fms, Gs^Fms, Gs, Hh, Hh, Mm, Mm, Xu, Xu, Xu, Xu, Xu, Xu, Xu, Xu, Xu, Xu, Xu, Xu, Xu, Xu, Xu, Xu, Xu, Xu, Xu, Xu, Xu, Xu, Xu, Xu, Xu, Xu, Xu, Xu, Xu, Xu, Xu
Gs^Fp, Gs^Fp, Ss, Gs^Fp, Gs^Fdw, Gs^Fms, Gs, Hh, Hh, Mm, Mm, Xu, Xu, Xu, Xu, Xu, Xu, Xu, Xu, Xu, Xu, Xuc, Xuc, Xu, Xu, Xu, Xu, Xu, Xu, Xu, Xu, Xu, Xu, Xu, Xu, Xu, Xu, Xu, Xu, Xu, Xu, Xu
Gs^Fms, Gs^Fp, Ss, Ss, Gs^Fmw, Gs^Fdw, Gs, Gs, Gd, Hh, Gd, Mm, Xu, Xu, Xu, Xuc, Xuc, Xu, Xuc, Xu, Xu, Xu, Xu, Xu, Mm, Xu, Xu, Xu, Xu, Xu, Xu, Xu, Xu, Xu, Xu, Xu, Xu, Xu, Xu, Xu, Xu, Xu
Gs^Fp, Gd^Fmw, Gs^Fmw, Gs^Fmw, Gs, Gs^Fmw, Gs, Gs^Fms, Gg, Gd, Hh, Rb, Xu, Xu, Xu, Uu, Uu, Xuc, Ce, Xuc, Xu, Xu, Xu, Xu, Mm, Mm, Mm, Mm, Mm, Mm, Mm, Mm, Mm, Mm, Mm, Mm, Mm, Mm, Mm, Mm, Mm, Mm
Gs^Fms, Gs^Fms, Gs^Fms, Gs, Gs^Fms, Gs, Gs^Fms, Gs^Fdw, Hh^Fp, Hh, Mm, Hh, Hh, Xu, Xu, Xu, Uu, Ce, Uu, Ce, Xu, Xuc, Xu, Mm, Mm, Mm, Mm, Mm, Mm, Mm, Mm, Mm, Mm, Mm, Mm, Mm, Mm, Mm, Mm, Mm, Mm, Mm
Gs, Gs, Gs, Gs, Gd^Fmw, Gs^Fms, Gd^Fmw, Hh^Fms, Gs^Fms, Hh^Fms, Hh, Mm, Mm, Xu, Xu, Xu, Xu, Xu, Xu, Xu, Xu, Xu, Xu, Mm, Hh, Hh, Hh, Hh, Hh, Hh, Hh, Hh, Hh, Hh, Hh, Hh, Hh, Hh, Hh, Hh, Hh, Hh
Gs, Gs, Gg, Gg, Gd^Fmw, Gs^Fms, Gd^Fmw, Gs^Fms, Gs, Gs, Hh, Mm, Mm, Xu, Mm, Xu, Hh, Rb, Rb, Hh, Hh, Mm, Mm, Mm, Hh, Gs, Gs, Gs, Gs, Gs, Gs, Gs, Gs, Gs, Gs, Gs, Gs, Gs, Gs, Gs, Gs, Gs
Gs, Gs, Gs, Gg, Gg, Gs^Fms, Gg, Gs^Fms, Gs, Hh, Hh, Mm, Hh, Mm, Hh, Mm, Hh, Rb, Rb, Gd, Gd, Hh, Hh, Hh, Hh, Gs, Gs, Gs, Gs, Gs, Gs, Gs, Gs, Gs, Gs, Gs, Gs^Gvs, Gs^Gvs, Gs^Gvs, Gs, Gs, Gs
Ss, Ss, Gs, Gg, Rb^Gvs, Gg, Gg, Gg, Gg, Gg, Hh, Hh, Hh, Hh, Gs, Hh, Gd, Gd, Gd, Rb, Gd, Gd, Gd, Gs, Rb, Rb, Rb, Rb, Rb, Gs, Gs^Gvs, Gs^Gvs, Gs^Gvs, Gs, Gs^Gvs, Gs^Gvs, Gs^Gvs, Gs^Gvs, Gs^Gvs, Gs^Gvs, Gs^Gvs, Gs
Gs, Gs, Gd^Fmw, Gg, Rb^Gvs, Rb^Gvs, Rb^Gvs, Gg, Gg, Gs, Gs, Gs, Gs, Gs, Gs, Gd, Gs, Gs, Gd, Gs, Rb, Gs, Rb, Rb, Gs^Fmw, Gs^Fmw, Gs^Fmw, Gs^Fmw, Gs^Fmw, Gs^Gvs, Gs^Gvs, Gs^Gvs, Gs^Gvs, Gs^Gvs, Gs^Gvs, Gs^Gvs, Cte, Gs^Gvs, Gs^Gvs, Gs^Gvs, Gs^Gvs, Gs^Gvs
Gg, Gg, Gg, Gg, Gs^Vl, Rb^Gvs, Gg, Gg, Gs^Fmw, Gs^Fmw, Gs^Fdw, Gg, Gg, Gg, Gs, Gs, Gs^Fms, Gs^Vht, Gs^Fms, Gs, Gs, Gs, Rb, Gs, Gs^Fmw, Gs^Fmw, Gs^Fmw, Gs^Fmw, Gs^Fmw, Gs^Fmw, Gs^Fmw, Gs^Gvs, Gs^Gvs, Gs^Gvs, Gs^Gvs, Gs, Cte, 3 Kte, Gs^Gvs, Gs^Gvs, Gs^Gvs, Gs^Gvs
Ww, Ww, Ds, Gg, Gg, Gg, Gg, Gs^Fms, Gs^Fmw, Ss, Gs^Fms, Gg, Gg, Gs, Gg, Gs, Gs^Fmw, Gs^Fmw, Gs^Fms, Gs, Rb, Gs, Gg, Gg, Gg, Gs^Fms, Gs^Fms, Gs^Fms, Gs^Fms, Gs^Fms, Gs^Fms, Gs^Fms, Gs^Gvs, Gs^Gvs, Gs^Gvs, Gs, Gs, Cte, Gs^Gvs, Gs^Gvs, Gs^Gvs, Gs^Gvs
Ww, Ww, Ww, Ds, Gg, Gg, Gg, Gd^Fmw, Gs^Fms, Gs^Fmw, Gs^Fms, Gg, Gg, Gg, Gg, Gs, Gs, Gs^Fms, Gs, Gs, Rb, Gs, Gg, Gs, Gs, Gs, Gs, Gs, Gs, Gs, Gs, Gs, Gs, Gs^Gvs, Gs, Gs, Gs, Gs, Gs, Gs, Gs, Gs
Ww, Ww, Ww, Ww, Gg, Gg, Gs^Fms, Gd^Fmw, Gs^Fp, Ss, Gs^Fp, Gs^Fms, Gs^Fms, Gg, Gg, Gg, Gs, Gs, Gs, Re, Gs, Rb, Gs, Gs, Ss, Ss, Ss, Ss, Ss, Ss, Gs, Ss, Gs, Gs, Ss, Gs, Ss, Gs, Gs, Ss, Ss, Ss
Ww, Ww, Ww, Ww, Ww, Gg, Gs^Fms, Gs^Fms, Gs^Fms, Gs^Fp, Ss, Ss, Gs^Fms, Gg, Gs, Gg, Gs, Re, Gs, Gs, Ss, Gs, Re, Gs, Ss, Ss, Ss, Ss, Ss, Gs, Ss, Gs, Ss, Gs, Gs, Ss, Gs, Ss, Gs, Gs, Gs, Ss
Ww, Ww, Ww, Ww, Ds, Ds, Gg, Gs^Fp, Gs^Fms, Ss, Ss, Gs^Fms, Rb^Gvs, Rb^Gvs, Gs, Gs, Re, Re, Gg^Vwm, Ss, Ss, Gs, Gs, Gs, Gs, Ss, Ss, Ss, Gs, Gs, Gs, Gs, Ss, Ss, Gs, Gs, Gs, Gs, Ss, Gs, Ss, Ss
Wo, Wo, Ww, Ww, Ds, Ds, Gg, Gg, Gs, Gs, Ss, Gs, Gs, Rb^Gvs, Gs, Re, Gs, Gs, Gs, Ss, Ss, Ss, Gs, Gs, Re, Gs, Gs, Gs, Gs, Gs, Gs, Gs, Gs, Gs, Gs, Gs, Gs, Gs, Gs, Gs, Gs, Gs
Wo, Wo, Ww, Ww, Ww, Ds, Gg, Gs, Ss, Ss, Ss^Vhs, Ss, Ss, Gs, Ww, Re, Ww, Ww, Ww, Ss, Gs, Gs, Gs, Gs, Gs, Gs, Gs, Gs, Gs, Gs, Gs, Gs, Gs, Gs, Gs, Gs, Gs, Gs, Gs, Gs, Gs, Gs
Wo, Wo, Wo, Ww, Ww, Gg, Gs, Gs, Ss, Ss, Gg, Gg, Ww, Ww, Ww, Ww^Bw|, Ww, Wo, Wo, Ww, Gs, Gs, Re, Re, Gs, Gs, Gs^Fms, Gs^Fms, Gs^Fms, Gs^Fms, Gs^Fms, Gs^Fms, Gs^Fms, Gs^Fms, Gs^Fms, Gs, Gs, Gs, Gs, Gs, Gs, Gs^Fms
Wo, Wo, Wo, Ww, Ww, Gg, Gg, Gs, Gs, Ss, Ww, Ww, Wo, Wo, Ww, Ww^Bw|, Gg, Ww, Ww, Ww, Ww^Bw/, Re, Gs, Gs, Gs, Gs^Fms, Gs^Fms, Gs^Fms, Gs^Fms, Gs^Fms, Gs^Fms, Gs^Fms, Gs^Fms, Gs^Fms, Gs^Fms, Gs^Fms, Gs, Gs^Fms, Gs^Fms, Gs^Fms, Gs, Gs^Fms
Wo, Wo, Wo, Ww, Ww, Ww, Hh, Gs, Gg, Ww, Wo, Wo, Ww, Ww, Ce, Rr, Ce, Ww, Ww^Bw/, Ww^Bw/, Ww, Ww, Ww, Ss, Gs, Gs^Fms, Gs^Fp, Gs^Fp, Gs^Fp, Gs^Fp, Gs, Gs, Gs^Fp, Gs^Fp, Gs^Fp, Gs, Gs^Fp, Gs^Fp, Gs^Fp, Gs^Fp, Gs, Gs^Fp
Wo, Wo, Wo, Ww, Ww, Ww, lighthouse_north Hh, Hh, Ww, Ww, Ww, Ww, Ds, Gg, Gg, Rr, Rr, Rr, Ce, Ww, Ww, Wo, Wo, Ww, Ww, Ww, Ww, Ww, Ww, Gs^Fp, Gs^Fp, Gs, Gs^Fp, Gs^Fp, Gs^Fp, Gs, Gs^Fp, Gs^Fp, Gs^Fp, Gs^Fp, Gs^Fp, Gs^Fp
Wo, Wo, Wo, Ww, Ww, Ww, Ww, Ww, Wo, Wo, Ww, Ww^Bw\, Ds, Gg, Rp^Vhc, Rr, Gs^Fds, Gg, Gg, Gg, Ds, Ww, Ww, Wo, Wo, Ww, Ww, Ww, Ww, Ww, Ww, Ww, Ww, Ww, Ww, Ww, Ww, Gs^Fp, Gs^Fp, Gs^Fp, Gs^Fp, Gs^Fp
Wo, Wo, Wo, Wo, Wo, Ww, Ww, Ww, Ww, Ww, Ww^Bw\, Ds, Re, Re, Rr, Rr, Gs, Gs^Fds, Rr^Vhc, Gg, Gg^Vh, Ds, Gs^Fds, Ww, Ww, Wo, Wo, Wo, Wo, Wo, Wo, Wo, Wo, Wo, Wo, Wo, Wo, Ww, Ww, Ww, Ww, Ww
Wo, Wo, Wo, Wo, Ww, Ww, Ww^Bw\, Ww, Gg, Ww, Ww, Ds, Gs, Rr^Vhc, Gs, Rr, Rr, Gs, Gs, Gg, Gg, Gs^Fds, Gs^Fds, Ww, Ww, Wo, Wo, Wo, Wo, Wo, Wo, Wo, Wo, Wo, Wo, Wo, Wo, Wo, Wo, Wo, Wo, Wo
Wo, Wo, Wo, Wo, Ww, Ww, Ds, Ds, Gg, Gg, Ww, Ww, Ce, Gs, Rr, Rr, Ch, Rr, Rr, Gs, Gg^Efm, Gg^Vh, Ds, Ww, Wo, Wo, Wo, Wo, Wo, Wo, Wo, Wo, Wo, Wo, Wo, Wo, Wo, Wo, Wo, Wo, Wo, Wo
Wo, Wo, Wo, Ww, Ww, Ww, Ds, Re, Re, Gg^Vh, Gg, Ww, Rr, Rr, Rr, Ch, 1 Kh, Ch, Rr, Gs, Gs, Ds, Ww, Ww, Ww, Ww, Ww, Ww, Ww, Ww, Ww, Ww, Ww, Ww, Ww, Wo, Wo, Wo, Wo, Wo, Wo, Wo
Wo, Wo, Wo, Ww, Ww, Ww^Bw\, Ds, Gg, Re, Rr, Rr, Ww^Bw/, Ce, Gs, Rr, Ch, Ch, Chr, Rr, Gg^Efm, Gs, Ds, Ww, Wo, Ww, Ww, Ww, Ww, Gg, Gg, Gg, Gg, Gg, Ww, Ww, Ww, Ww, Wo, Wo, merfolk_reinforcements Wo, Wo, Wo
Wo, Wo, Wo, Ww, Ww, Ww, Ds, Re, Gg, Gg^Vh, Gg^Efm, Ww, Gs, Gs, Rr^Vhc, Rr, caravan_start_1 Rr, Rr, Gs^Fds, Gs, Ce, Ww, Wo, Ww, Gg, Gg, Gg, Gg, Gs^Fms, Gs^Fms, Gs^Fms, Gg, Gg, Gg, Gg, Ww, Ww, Ww, Ww, Wo, Ww, Wo
Wo, Wo, Wo, Ww, Ww, Ww^Bw/, Ww, Ds, Ds, Gg^Efm, Ww, Ww, Gs^Fds, Gs^Fds, Gs, Gs, Gs, caravan_start_2 Rr, Re, Gs, Re, Ww, Ww, Ww, Gg, Gg, Gg, Gs^Fms, Gs^Fms, Gs^Fms, Gg, Gg, Re^Gvs, Gg, Gg, Ww, Ww, Ww, Ww, Ww, Ww, Ww
Wo, Wo, Wo, Wo, Ww, Ww, Ww, Ww^Bw/, Wwf, Gg, Ww, Ww, Ww, Gs^Fds, Gs, Rr^Vhc, Re, Rr, Gg^Vh, Re, Ce, Ww^Bw\, Ww^Bw\, Gg, Gg, Gs^Vl, Re, Gg, Gg, Gs^Fms, Gg, Re^Gvs, Re^Gvs, Re^Gvs, Re^Gvs, Gg, Ww, Ww, Gg, Gg, Gg, Ww
Wo, Wo, Wo, Wo, Wo, Ww, Ww, Ww, Wwf, Wwf, Ww, Wo, Ww^Bw/, Ds, Re, Re, Gg, Rr, Gg, Gg, Ke, Ww, Ww, Re, Re, Gg, Gg, Re, Gg, Gg, Gg, Re^Gvs, Re^Gvs, Re^Gvs, Re^Gvs, Gg, Ww, Ww, Ww, Gg, Gg, Gg
Wo, Wo, Wo, Wo, Ww, Ww, lighthouse_south Hh, Wwf, Wwf, Ww, Wo, Ww, Ww, Ds, Ds, Gg, Ce, caravan_start_3 Rr, Ce, Ke, Ww, Ww, Ww, Gg, Re, Gg, Gs^Fms, Gs^Fms, Gs^Fms, Gg, Gg, Re^Gvs, Re^Gvs, Re^Gvs, Re^Gvs, Gg, Gg, Ww, Ww, Ww, Gg, Gg
Wo, Wo, Wo, Ww, Ww, Ww, Gg, Gg, Gs^Fds, Ww, Wo, Ww, Ww, Ww^Bw/, Ww, Gg, Ww, caravan_start_4 Ww^Bw|, Ww, Ww, Ww, Ww, Gg, Gg, Re, Gg, Gg^Efm, Gs^Fms, Gs^Fms, Gg^Efm, Gg^Efm, Re^Gvs, Re^Gvs, Re^Gvs, Re^Gvs, Re^Gvs, Gg^Efm, Gg^Efm, Ww, Ww, Gg^Efm, Gg^Efm
Wo, Wo, Ww, Ww, Gg, Gg, Gg, Gs^Fds, Gs^Fds, Ww, Ww, Ww, Ww, Ww, Ww, Ww, Ww, Ww^Bw|, Ww, Ww, Gg, Gg, Gg, Gg, Re, Gg^Efm, Gg, Gg, Gg, Gg, Gg, Gg, Gs^Vl, Re^Gvs, Gg, Gg^Efm, Gg, Gg^Efm, Ww, Ww, Ww, Gg
Wo, Wo, Ww, Ww, Gg, Gs^Fms, Gs^Fms, Gs^Fds, Gs^Fds, Gs^Fds, Gg, Gg, Gg, Ww, Gg^Efm, Ww, Gg, Re, Gg, Gg, Re^Gvs, Re^Gvs, Gg, Re, Gg, Gg, Gg^Efm, Gg^Efm, Gs^Fms, Gg^Efm, Gg^Efm, Gg^Efm, Gg^Efm, Gg^Efm, Gg, Gg^Efm, Gs^Fms, Gs^Fms, Hh, Ww, Ww, Hh
Wo, Wo, Wo, Ww, Ww, Gs^Fds, Gg, Gs^Fds, Gg, Gs^Fds, Re^Gvs, Gg, Re^Gvs, Gg^Efm, Re^Gvs, Gg, Gg^Efm, Re, Re, Gg, Gg, Gg, Re, Re, Gg, Gg, Gs^Fms, Gs^Fms, Gs^Fms, Gs^Fms, Gs^Fms, Gg, Gg, Gg^Efm, Gg^Efm, Gs^Fms, Gs^Fms, Gs^Fms, Hh, Hh, Ww, Ww
Wo, Wo, Wo, Wo, Ww, Gg, Gg, Gg^Efm, Re^Gvs, Re^Gvs, Re^Gvs, Re^Gvs, Re^Gvs, Re^Gvs, Gg, Gg, Gg, Gg, Gs^Fds, Re, Re, Re, Gg, Gg, Re^Gvs, Gs^Vl, Gs^Fds, Gs^Fms, Gs^Fms, Gs^Fms, Gs^Fms, Gs^Fms, Gs^Fms, Gs^Fms, Gs^Fms, Gs^Fms, Gs^Fms, Gs^Fms, Gs^Fms, Hh, Ww, Ww
Wo, Wo, Wo, Wo, Ww, Ww, Ds, Gg, Re^Gvs, Re^Gvs, Re^Gvs, Re^Gvs, Gg, Gg, Gg, Gs^Fds, Gs^Fds, Gs^Fms, Gs^Fds, Re, Gs^Fds, Gg, Gs^Vl, Re^Gvs, Re^Gvs, Gs^Fds, Gs^Fds, Gs^Fds, Gs^Fds, Gs^Fds, Gs^Fds, Gs^Fds, Gs^Fds, Gs^Fds, Gs^Fds, Gs^Fds, Gs^Fds, Gs^Fds, Gs^Fds, Hh, Ww, Ww
Wo, Wo, Wo, Ww, Ww, Ww, Ds, Gg, Gs^Vl, Re^Gvs, Gs^Fms, Gs^Fms, Gs^Fms, Gg, Gg, Gs^Fms, Gg, Gg, Gg, Re, Gs^Fds, Gs^Fds, Gs^Fds, Re^Gvs, Gg, Gg, Gg, Gs^Fms, Gg, Gg, Gs^Fds, Gg, Gg, Gg, Gg, Gg, Gg, Gg, Gg, Gg, Gg, Ww
Wo, Wo, Wo, Ww, Ww, Ds, Gg, Gg, Gs^Fds, Gs^Fds, Gs^Fms, Gs^Fds, Gg, Gg, Gg, Gg, Gg, Gs^Vl, Re, Re, Gg, Gs^Fds, Gg, Gg, Re^Gvs, Re^Gvs, Gg, Gg, Gg, Gs^Fds, Gg, Gg, Gg, Gg, Gg, Gs^Fds, Gs^Fds, Gg, Gg, Gg, Gg, Ww
Wo, Wo, Wo, Ww, Ww, Ds, Gg, Gg, Gs^Fms, Gs^Fms, Gg^Fet, Gs^Fms, Gg, Gg, Gg, Gg, Gg, Re, Re, Re, Re, Gg, Re, Gg, Gg, Re^Gvs, Gg, Gg, Gg, Gs^Fds, Gg, Gg, Ce, Ce, Gg, Gs^Fds, Gs^Fds, Gg, Gg, Gg, Gg, Ww
Wo, Wo, Wo, Ww, Ww, Ds, Gg, Gg, Gs^Fms, Gg, Gs^Fms, Gs^Fms, Gs^Fms, Gg, Gg, Gg, Gg, Re, Gg, Gg, Gg, Re, Gs^Vl, Re, Re, Gg, Gg, Gg, Gg, Gg, Gg, Ce, 2 Ket, Ce, Ce, Gg, Gg, Gg, Gg, Gg, Gg, Gg
Wo, Wo, Wo, Ww, Ww, Ds, Gg, Gg, Gg, Gs^Fms, Gs^Fms, Gs^Fms, Gs^Fds, Gs^Fms, Gg, Gg, Gg, Re, Gg, Gg, Gg, Gg, Gg, Gg, Gs^Fds, Re, Re, Gg, Gg, Gg, Gg, Ce, Ce, Ce, Gs^Fds, Gg, Gg, Gg, Gg, Gg, Gg, Gg
Wo, Wo, Wo, Ww, Ww, Ds, Gg, Gg, Gs^Fms, Gs^Fms, Gs^Fms, Gs^Fds, Gs^Fms, Gs^Fds, Gs^Fds, Gg, Re, Re, Gs^Fds, Gs^Fds, Gg^Efm, Gs^Fds, Gs^Fds, Gs^Fms, Gs^Fds, Hh, Hh, Re, Gg, Gs^Fds, Gs^Fds, Ce, Gg, Gs^Fds, Gg, Gg, Gg, Gg, Gg, Gg, Gg, Gg
Wo, Wo, Wo, Ww, Ww, Gg, Gg, Gg, Gs^Fms, Gs^Fds, Gs^Fms, Gs^Fms, Gs^Fms, Gs^Fds, Gs^Fds, Gg, Re, Gg, Gg, Gg, Gg, Gg, Gs^Fms, Gs^Fms, Hh, Hh, Hh, Re, Re, Gs^Fds, Gg, Gg, Gg, Gg, Gg, Gg, Gg, Gg, Gg, Gg, Gg, Gg
Wo, Wo, Wo, Ww, Ww, Gg, Gg, Gg, Gg, Gs^Fms, Gg, Gs^Fds, Gg, Gs^Fms, Gg, Re, Re, Gg, Gg, Gg, Gg, Gg, Gg, Gs^Fms, Gg, Hh, Gg, Gs^Fds, Gg, Re, Re, Gg, Gg, Gg, Gg, Gg, Gg, Gg, Gg, Gg, Gg, Gg
